FFFFFFFFFFWWWWWDDDDDDDDDDFFFFFFFFFFFFFFFFFFFFFFFFF
FFFFFFFFFWWWWWWDDDDDDDDDDDFFFFFFFFFFFFFFFFFFFFFFFF
FFFFFFFFFFWWWWWWDDDDDDDDFFFFFFFWFFFFFFFFFFFFFFFFFF
FFFFFFFFFFWWWWWWDDDDDDDDFFFFFFFWWFFFFDFFFFFFFFFFFF
FFFFFFFFFFFWWWWDDDDDDDDDFFFFFFFFFFFFDDFFFFFFFFFFFF
WWWFFFDDDFFDDDFFFFFDDWWWFFFFFFWWWWWDDDDDDDDDDDDFFF
WWWWDDDDDDDDDDFFFFFFWWWWWWFFWWWWWWWDDDDDDDDDDDDDFF
WWWWDDDDDDDDDDDFFFFFWWWWWWWWWWWWWWWDDDDDDDDDDDDDDF
WWWWWDDDDDDDDDDFFFFFWWWWWWWWFFWWWWWDDDDDDDDDDDDDDD
WWWWWWDDDDDDDDDDFFFFWWWWWFFFFFWWWWWWFDDDDDDDDDDDDD
WWWWWDDDDDDDDDDFFFFFFFFDDDDDDDWWWWWFFFFFDDDDDDDDDD
WWWWDDDDDDDDDDFFFFFFFFFFDDDDDDWWWWWFFFFFDDDDDDDDDD
WWWWDDDDDDDDDDDFFFFFFFFFFDDDDDWWWWWFFFFFDDDDDDDDDD
WWWWWDDDDDDDDDFFFFFFFFFFFDDDDDWWWWFFFFFFDDDDDDDDDF
WWWWWDDDDFFDDDFFFWFFFFFFDDDDDFWDDFFFFFFFDDDDDDDDFF
DDDDDDDDDFFFFFFWWWWWDDDDDFFFFFFDDDDDDDDDDDDDDFFFFF
DDDDDDDDDDFFFFFWWWWWWDDDDFFFFFFDDDDDDDDDDDDDDFFFFF
DDDDDDDDDFFFFFFWWWWWDDDDDFFFFFDDDDDDDDDDDDDDDFFFFF
DDDDDDDDDDFFFFFWWWWWDDDDDFFFFFDDDDDDDDDDDDDDFFFFFF
DDDDDDDDDDFFFFWWWWWWDDDDWWFFFFDDDDDDDDDDDDDFFFFFFD
WWWWWFFFFFDDDDWWFFFFFFFFWWWWWWWWWWDDDDDDFFFFFFDDDD
WWWWWFFFFFDDDDDFFFFFFFFFFWWWWWWWWWWDDDDDFFFFFDDDDD
WWWWWFFFFFDDDDFFFFFFFFFFFFWWWWWWWWWDDDDDFFFFFDDDDD
WWWWWFFFFFDDDDDFFFFFFFFFFWWWWWWWWWWDDDDDDFFFFDDDDD
WWWWWFFFFFFDDDDFFFFFFFFFFWWWWWWWWWFFDDDDDDFFDDDDDD
DDDDDDFFFFFDWWWWWWWWDDDDDFFFFFDDDDFFFFWWDDWWDDWWWW
DDDDDFFFFFWWWWWWWWWWDDDDDFFFFFDDDDDFFFWWWWWWWDWWWW
DDDDFFFFFFWWWWWWWWWWDDDDDFFFFFDDDDDFFFFWWWWWWWWWWW
DDDDFFFFFWWWWWWWWWWWDDDDDFFFFFDDDDDFFFFFFWWWWWWWWW
DDDDDFFFFFFWWWWWWWWWDDDDDFFFFDDDDDDDFFFFFFWWWWWWWW
DDDDDDFFFFFFWWWFFFFFDDWWDDDDDDDFFDDWWWFFFFFFFFFFFF
DDDDDDDFFFWFWWWFFFFFDDWWWWWDDDFFFFFWWWWWFFFFFFFFFF
DDDDDDFFFFWWWWWFFFFFDDWWWDWWDDFFFFFWWWWWWFFFFFFFFF
DDDDDFFFFWWWWWWFFFFDDDDDDDDWDDFFFFFWWWWWWWFFFFFFFF
DDDDFFFFWWWWWWWFFFFDDDDWWDDWDFFFFFDDWWWWWWWFFFFFFF
WWWWWFFFFFWWWWWWWWWDDFFFWWWWWFFFDDDDFFFWWWWWWWWWWW
WWWWWWFFFFWWWWWWWWWDDFFFWWWWWWDDDDDDFFFFWWWWWWWWWW
WWWWWFFFFWWWWWWWWWWWFFFFFWWWWWDDDDDDFFFFWFFFWWWWWW
WWWWDDFFFFWWWWWWWWWWFFFFFWWWWWDDDDFFFFFFFFFWWWWWWW
WWWWDDFFFFWWWWWWWWWFFFFFFWWWWWDDDFFFFFFFFFWWWWWWWW
FFFFDDDDDDWWWWWFFFFFFFFWWWWFFFDDDDFFFFFFFFFFWWWWWW
FFFFFFDDDDWWWWWFFFFFWFFWWWFFFFDDDDDFFFFFFFFFFWWWWW
FFFFDDDDDDWWWWWFFFFFWWWWWFFFFFDDDDDFFFFFFFFFFWWWWW
FFFFFFDDDDDWWFFFFFFWWWWWWFFFFFDDDDDFFFFFFFFFFWWWWW
FFFFFDDDDDDWFFFFFFWWWWWWWWFFFFDDDFFFFFFFFFFFFFWWWW
DDFFWWWWDDDFFFFFWWWWWWWWWWWWWWWWWDDDDDDDFWWWFWWWWW
DDFDWWWWWWFFFFFWWWWWWWWWWWWWWWWWWWDDDDDDDWWWWWWWWW
DDDDDWWWWWFFFFFWWWWWWWWWWWWWWWWWWWWDDDDDWWWWWWWWWW
DDDDDWWWWWFFFFFWWWWWWWWWWWWWWWWWWWWDDDDDWWWWWWWWWW
DDDDDWWWWWFFFFFWWWWWWWWWWWWWWWWWWWWDDDDDWWWWWWWWWW
